1 13 31
###############################
#p     bs *  1 * 2 *  * * *   #
# # # #*# # #*#*# # # #f#*#*# #
#  x*     ***  *  *   * 2 * * #
# # # # # #s# # #*#*# # # # #*#
#f         x f*  *  *   *     #
# # # # # # # # # #*# #*# # # #
#*  *      *  *      *        #
# # # # #*# # # #s#*# # # # # #
#*    **  *       *           #
# #*# # # # # # #*# # # # # # #
#   1       *   *  *          #
###############################
