1 13 31
###############################
#p     bs *  1 * 2 *  * * *   #
# # # #*# # #*#*# # # #f#*#*# #
#  x*                 * 2 * * #
# # # #*# #s# # #*#*# # # # #*#
#f    *2*  x f*  *  *   *     #
# # # #*# # # # # #*# #*# # # #
#*  *      *  *      *        #
# # # # #*# # # #s#*# # # # # #
#*    **  *       *           #
# #*# # # # # # #*# # # # # # #
#   1       *   *  *          #
###############################
