1 13 31
###############################
#      bs *  1 * 1 *  * * *   #
#       # # #*#*# # # #f#*#*# #
#    2  # ***  *  *   *   * * #
#   # # # #s# # #*#*# x # # #*#
#          x f*  *  *   *     #
# # # # # # # # # #*# #*# # # #
#*  *      *  *      *        #
# # # # #*# # # #s#*# # # # # #
#*    **  *       *           #
# #*# # # # # # #*#         2 #
#   1       *   *  *          #
###############################
