1 13 31
###############################
#p     bs *  1 * 2 *  * * *   #
# # # #*# # #*#*# # # #f#*#*# #
#  x*     ***  *  1   * 2 * * #
# # # # # #s# # #*#*# # # # #*#
#f         x f*  *  *   1     #
# # # # # # # # # #*# #*# # # #
#*  *      *  *      *        #
# # # # #*# # # #s#*# # # # # #
#*    **  *       *           #
# #*# # # # # # #*# # # # # # #
#           *   *  *          #
###############################
