1 13 31
###############################
#p     bs        2 *  * * *   #
# # # #*# # #*#*#*# # #f#*#*# #
#  x*       3         *   * * #
# # # #*# #s# # #*#*# # # # #*#
#f    * *  x f*  *  *   *     #
# # # #*# # # # # #*# #*# # # #
#*  *      *  *      *        #
# # # # #*# # # #s#*# # # # # #
#*    **  *       *           #
# #*# # # # # # #*# # # # # # #
#   1       *   *  *          #
###############################
