3 13 31
###############################
#p   ** **    *   5           #
# # # #*# # # # # # # # # # # #
#*     ** * *  *   * **   *   #
# # # # # #*# # # # # # #*# # #
#*   *s*    *** * x **   3    #
# # # # # # # # # # # # # #*# #
#    * 5   *        *    **  3#
# #*# # #*#*#*#*# # # # # #*# #
#        *   *2*    *   *     #
#*# # # # # # # # # # #*# # #*#
# *    * **    ** ***   1 1   #
###############################